3 21 925 1133 1422 1901 31 1924 106 1395 721 708 1264 839 1954 1964 1431 792 1979 1169 1046 491 1988 
3 8 1982 636 538 841 361 305 1089 964 
3 15 215 392 1968 616 1475 1948 1946 1090 894 1922 929 161 17 1934 964 
3 6 925 1874 1485 1241 35 1846 
3 5 1846 865 685 989 1050 
3 4 1050 229 1805 460 
3 4 460 349 724 1789 
3 5 1789 656 439 249 111 
3 6 111 1144 1344 682 941 1758 
3 7 1758 1757 1754 489 1591 228 1740 
3 11 1740 884 104 896 1380 1726 7 580 1715 1039 1295 
3 7 429 1684 400 995 6 330 304 
3 4 1354 889 198 429 
3 3 1354 435 1295 
3 13 1295 1039 1715 580 7 1726 1380 896 104 884 1740 228 1591 
3 7 249 487 1160 447 966 1765 1137 
3 7 1137 1759 1097 860 1164 1287 947 
3 8 1039 1127 188 1556 1445 322 1714 1214 
3 4 304 1596 1522 95 
3 6 1666 1665 956 224 290 1540 
3 2 1485 1853 
3 5 1845 163 1440 505 1853 
3 5 1007 987 1385 221 1845 
3 3 1007 38 370 
3 5 370 1374 76 1272 1800 
3 8 1800 1191 1804 569 1807 678 1815 459 
3 8 459 296 1821 1251 1100 846 1825 1826 
3 5 1005 345 789 1835 1440 
3 5 1005 551 1806 1801 272 
3 9 1377 1496 963 1304 1121 1786 1013 1566 272 
3 15 215 1042 1981 1989 626 589 360 1977 731 282 1273 955 829 534 1983 
3 12 1983 1510 1118 1443 1434 501 1487 518 220 2007 173 2004 
3 12 2004 1593 1546 1302 110 66 1187 2025 1172 723 2017 2014 
3 6 2014 2020 702 1208 844 2024 
3 6 823 1106 343 2048 885 994 
3 4 994 745 1145 226 
3 7 226 838 2084 959 2095 61 2098 
3 6 2098 1527 1184 1340 805 275 
3 7 275 1560 1515 672 665 1398 1078 
3 6 1010 1548 793 1554 1068 245 
1 9 982 1106 358 826 348 408 1201 1226 1032 
1 5 1226 1534 442 2085 2083 
1 3 2083 791 52 
1 5 52 167 1346 943 1435 
1 7 1435 655 768 1411 688 586 1481 
1 7 1481 1392 151 1338 288 2116 92 
2 5 982 2028 2029 2037 994 
2 4 885 1044 2033 982 
2 4 1468 1267 714 994 
1 3 1468 863 1415 
1 4 863 1249 520 2081 
1 3 2081 2071 226 
1 4 520 245 1258 1102 
1 2 1258 1554 
1 4 520 535 344 793 
1 3 793 1325 1548 
1 3 959 1163 2095 
1 2 1527 926 
1 3 2028 1044 2048 
2 4 745 2059 149 2048 
1 2 2059 1145 
1 9 838 1221 2075 1001 1410 1536 2078 1297 442 
2 5 2048 1154 2061 902 1001 
1 9 2098 2097 659 980 143 466 75 2090 2085 
1 4 665 1103 1261 1078 
1 7 1078 2115 2122 1140 2126 1157 1512 
1 3 1398 1277 2114 
1 6 805 824 2110 529 14 2114 
1 4 384 1324 2112 1481 
1 4 2114 641 1122 384 
1 5 384 1355 1516 375 14 
1 10 1663 1540 211 1661 295 1659 764 1658 712 654 
1 3 211 1176 1661 
1 7 654 1649 875 1650 619 1526 1009 
1 8 1009 1655 771 1171 1647 1002 1223 284 
1 9 1629 1632 34 451 476 766 1643 774 654 
1 4 1629 153 803 670 
2 2 670 270 
1 6 46 1470 471 1615 93 145 
1 2 93 1095 
1 4 46 1366 604 573 
1 3 573 1641 1002 
2 4 670 1469 1070 1115 
1 2 1115 573 
1 3 1070 1000 1366 
1 10 145 440 1336 60 461 269 472 302 1033 467 
1 8 573 298 1438 1633 403 1464 140 74 
1 4 145 1617 1621 1626 
1 4 1615 1619 83 1626 
1 3 1626 250 1464 
1 9 74 357 1636 1161 1343 43 1073 72 366 
1 5 366 165 1087 1299 1322 
1 5 440 733 796 64 1108 
1 7 1108 1036 1612 634 1610 291 1606 
1 3 1606 769 1611 
1 7 1611 1018 1614 262 762 1625 72 
1 14 1419 455 1030 999 1193 726 920 2035 2040 193 599 2034 16 2050 
1 5 2050 192 233 1397 286 
1 4 2050 1052 568 286 
1 2 286 1065 
1 7 1419 252 1472 598 2022 1059 567 
1 3 1059 753 2036 
1 7 1030 565 970 2030 2031 612 753 
1 7 2036 2041 506 992 2057 1480 1430 
1 5 1065 232 996 1416 260 
1 3 260 306 719 
1 4 719 1031 465 2068 
1 7 2068 571 827 2052 273 2038 970 
1 33 2024 390 2005 1229 2003 448 611 693 406 1992 780 1980 1386 1975 1971 630 1956 1940 1935 1931 703 30 500 58 1474 1893 1182 918 1384 876 186 1890 1558 
1 8 1558 648 1326 1886 1882 1228 483 713 
1 4 693 1280 351 2020 
1 4 2014 737 746 2020 
1 3 702 2027 746 
1 5 1187 1093 903 1224 110 
1 2 66 1245 
1 6 1975 1986 441 1555 756 2014 
2 2 1593 462 
2 4 173 2012 194 2007 
2 6 2004 227 1995 347 676 1129 
1 5 1129 1383 590 419 501 
1 3 1383 635 971 
1 4 1474 1055 985 971 
1 2 1983 1999 
1 2 1118 2000 
1 5 501 1048 1985 1207 1510 
1 2 1118 1207 
1 4 1207 748 1963 1943 
1 6 1943 1202 127 339 1902 1384 
1 4 971 1196 1939 1943 
1 3 1983 1513 829 
1 4 1250 444 409 534 
1 5 1250 584 1911 1899 1886 
1 2 1899 430 
1 7 1943 1047 528 1941 209 1114 1250 
1 3 282 877 955 
1 3 1250 1230 485 
1 4 485 1575 1959 731 
1 4 713 1412 1903 673 
1 6 673 1080 182 831 1966 1977 
1 6 1561 1669 1086 1105 1671 1674 
1 6 429 1685 1689 318 1352 364 
1 25 304 1378 1682 1198 90 81 1677 1679 1683 510 1690 1692 1239 474 1081 1707 367 1214 1170 1718 687 1725 578 362 862 
1 3 1580 950 367 
1 8 474 663 898 618 1694 132 1552 1682 
1 7 618 911 582 1413 945 1701 435 
1 7 1713 1293 133 1311 854 134 1039 
1 6 7 1722 1477 720 754 1544 
1 6 1726 426 620 1225 1721 1445 
1 16 862 1738 856 1741 247 168 650 1755 199 120 1764 1767 954 1775 934 1377 
1 10 1496 511 1778 281 118 609 1794 637 738 1162 
1 5 884 1192 404 1576 1437 
1 8 947 711 658 1175 216 1128 602 1225 
1 5 247 1309 1747 832 947 
1 5 947 1746 201 1750 489 
2 3 1758 531 1756 
1 2 1137 545 
2 3 1758 1761 503 
1 2 1757 503 
1 4 1570 1541 387 489 
1 3 387 1320 1757 
1 2 387 228 
1 4 1764 549 1029 966 
1 19 682 1027 681 1774 1444 669 874 1790 238 1120 1799 321 1808 1812 446 1448 572 1240 1842 
1 6 1789 1096 1104 628 1523 1799 
1 9 1789 808 624 164 206 784 677 1777 1775 
1 3 1377 1165 954 
1 6 1775 464 244 790 1304 1778 
1 4 609 523 475 1786 
1 7 164 825 1173 155 225 1321 1566 
1 8 724 1082 853 1210 897 36 184 1240 
1 3 989 1449 1050 
1 2 1449 1817 
1 4 1811 1269 848 989 
1 6 1846 1200 207 1837 1284 1123 
1 8 1846 1843 1839 502 1838 1537 871 1835 
1 3 789 522 1827 
1 3 1440 1298 1848 
1 5 221 1270 692 102 1872 
1 11 1872 548 68 1879 413 1151 166 765 1873 645 1232 
1 6 548 1069 601 1426 953 1264 
1 7 1872 116 1389 279 1841 1312 1007 
1 6 1191 44 1816 639 729 1841 
1 3 1395 1476 627 
2 4 1422 354 1920 653 
1 2 1920 31 
2 3 1873 280 1874 
2 2 166 315 
1 2 315 31 
2 4 1422 969 334 166 
2 9 1883 1877 700 382 1256 1485 988 1869 1873 
1 10 891 421 1908 383 923 515 725 1937 1500 479 
1 3 1908 1915 540 
1 5 479 1906 1088 1461 519 
1 5 1088 1584 743 1878 423 
1 3 743 42 519 
1 6 42 458 1862 1275 543 423 
1 3 42 181 1578 
1 7 1578 178 1159 957 338 1123 1842 
1 2 1862 1111 
2 3 1874 553 700 
1 2 1578 382 
1 2 1256 553 
1 2 1485 553 
1 3 1133 969 280 
1 6 1853 631 1857 872 1583 1873 
1 4 872 1861 217 1485 
1 5 370 680 63 235 1566 
1 13 279 1098 802 109 1186 651 490 341 1564 709 432 591 538 
1 11 279 240 8 1391 336 1888 125 932 112 1923 958 
1 10 459 477 214 190 333 1875 53 1891 1396 958 
1 5 1396 1316 1441 603 929 
1 3 1441 1478 1934 
2 2 1089 55 
1 9 1571 1349 73 1423 1506 1117 1497 1012 1947 
1 3 706 266 1423 
1 3 1467 1071 1117 
1 34 73 770 2019 1168 2023 1255 2039 866 2046 1458 197 2058 1337 1371 2074 493 2073 428 1300 2054 1459 1279 1308 893 1400 979 2016 867 2008 509 1597 301 1079 1467 
1 7 1071 1038 900 1948 1936 12 894 
1 8 1922 1408 1557 570 1921 905 1944 1475 
1 3 325 1251 679 
1 6 1802 647 307 1810 1814 846 
1 5 1826 1832 1550 1840 1209 
1 21 1209 562 605 1859 533 1203 632 1124 1282 728 1904 285 1266 39 1533 1022 1547 1925 456 739 673 
1 3 605 314 937 
1 2 632 1557 
1 6 1925 1933 1306 1953 1542 589 
2 5 1306 1498 1040 906 1042 
1 5 1547 148 1942 557 616 
2 5 215 1125 773 998 113 
1 3 509 1587 1597 
2 3 1597 65 215 
1 3 65 433 616 
1 2 433 301 
1 2 1115 1002 
1 3 503 1570 1194 
1 3 1756 1084 1759 
2 4 891 519 1884 1877 
1 2 1947 964 
2 4 958 1926 256 1089 
1 2 113 893 
