1 6 870 91 282 9 670 59 
1 6 59 268 275 921 204 935 
1 3 935 28 750 
1 15 750 203 451 940 859 197 400 939 632 942 943 71 945 881 886 
1 8 750 5 124 432 794 107 198 621 
1 4 621 86 434 74 
1 4 92 279 250 74 
1 6 92 257 230 412 576 59 
1 11 293 385 957 676 843 722 963 556 612 966 370 
3 49 578 1044 702 1038 338 1031 688 126 1020 229 840 500 37 1007 427 256 718 559 643 80 984 781 253 471 669 373 269 607 104 586 967 783 45 772 24 650 959 517 296 50 293 743 566 570 948 384 946 351 881 
3 6 370 459 968 367 62 967 
1 12 370 970 348 551 674 850 475 29 237 374 123 987 
3 4 987 711 643 80 
1 8 29 696 444 396 986 828 819 258 
1 4 126 1027 787 267 
1 15 267 410 1025 562 878 389 887 109 1006 519 873 626 662 996 718 
3 25 578 1044 702 672 309 292 228 311 1032 103 115 248 892 392 242 15 804 184 1022 712 802 277 609 648 548 
1 10 258 991 817 1001 735 855 682 1011 61 804 
1 6 311 394 777 120 1026 126 
1 3 578 534 270 
1 8 578 534 94 498 491 656 697 267 
1 6 578 289 288 260 539 90 
1 5 90 1041 115 248 892 
3 31 578 289 381 14 749 560 572 1064 303 112 713 919 298 1081 565 466 1078 844 488 800 591 492 30 397 172 424 1074 291 473 520 144 
1 4 90 119 303 112 
1 6 548 281 807 1030 755 194 
1 8 862 19 300 590 1046 201 654 194 
1 2 862 291 
1 3 243 457 591 
1 4 243 163 547 201 
1 5 591 492 159 1075 336 
1 17 336 364 677 695 136 686 368 207 826 694 1113 758 226 857 208 1099 211 
1 5 211 831 1092 664 144 
1 3 144 212 118 
1 4 118 627 473 291 
3 36 144 835 685 42 763 1076 604 667 567 1082 524 1080 78 563 573 332 358 1089 13 1085 415 1091 732 595 149 1095 842 1097 414 48 640 485 867 295 710 1105 
1 7 679 1051 555 698 1050 521 150 
1 14 150 484 220 1056 1059 145 791 705 583 766 254 874 846 891 
1 4 891 153 640 485 
1 14 679 180 752 371 744 693 162 780 372 93 1046 201 654 194 
1 7 294 532 308 611 1101 716 784 
1 14 1110 736 1116 769 168 569 1123 1125 660 914 496 861 20 784 
1 4 294 404 742 340 
1 10 340 658 408 529 646 1114 1111 848 318 1110 
3 8 1105 635 185 647 489 353 589 356 
1 4 1105 710 295 867 
1 7 1105 483 189 770 1120 437 767 
3 10 720 342 1128 241 405 761 117 561 851 767 
1 10 720 610 663 461 678 39 637 756 645 511 
1 11 511 515 803 614 808 506 833 18 1122 284 271 
1 9 1105 483 1108 399 514 1112 218 599 271 
1 4 1082 524 1093 294 
