3 21 925 1133 1422 1901 31 1924 106 1395 721 708 1264 839 1954 1964 1431 792 1979 1169 1046 491 1988 
3 8 1982 636 538 841 361 305 1089 964 
3 15 215 392 1968 616 1475 1948 1936 12 894 1922 929 161 17 1934 964 
3 15 964 1934 17 161 929 1922 894 12 1936 1948 1475 616 1968 392 215 
3 6 925 1874 1485 1241 35 1846 
3 5 1846 865 685 989 1050 
3 4 1050 229 1805 460 
3 4 460 349 724 1789 
3 5 1789 656 439 249 111 
3 6 111 1144 1027 682 941 1758 
3 7 1758 1757 1754 489 1591 228 1740 
3 11 1740 884 104 896 1380 1726 7 580 1715 1039 1295 
3 5 304 330 6 995 400 
3 4 400 198 889 1354 
3 3 1354 435 1295 
3 13 1295 1039 1715 580 7 1726 1380 896 104 884 1740 228 1591 
3 7 249 487 1160 447 966 1765 1137 
3 7 1137 1759 1097 860 1164 1287 947 
3 8 1214 751 185 1556 292 188 180 1295 
3 4 304 1596 1522 95 
3 6 1666 1665 956 224 290 1540 
3 2 1485 1853 
3 5 1853 871 1835 163 1845 
3 6 1845 1270 221 1385 987 1007 
3 3 1007 38 370 
3 4 370 1374 76 1162 
3 10 1162 1798 1800 1191 1804 569 1807 678 1815 459 
3 8 1826 1825 317 577 1251 1821 296 459 
3 4 1835 789 345 1005 
3 5 1005 551 1806 1801 272 
3 9 1377 1496 963 1304 1121 1786 1013 1566 272 
3 15 215 1042 1981 1989 626 589 360 1977 731 282 1273 955 829 534 1983 
3 12 1983 1510 1118 1443 1434 501 1487 518 220 2007 173 2004 
3 12 2004 1593 1546 1302 110 66 1187 2025 1172 723 2017 2014 
3 6 2014 2020 2027 1208 844 2024 
3 6 823 1106 343 2048 885 994 
3 4 994 745 1145 226 
3 7 226 838 2084 959 2095 61 2098 
3 6 2098 1527 1184 1340 805 275 
3 7 275 1560 1515 672 665 1398 1078 
3 6 1010 1548 793 1554 1068 245 
