3 21 925 1133 1422 1901 31 1924 106 1395 721 708 1264 839 1954 1964 1431 792 1979 1169 1046 491 1988 
3 8 1982 636 538 841 361 305 1089 964 
3 15 215 392 1968 616 1475 1948 1936 12 894 1922 929 161 17 1934 964 
3 15 964 1934 17 161 929 1922 894 12 1936 1948 1475 616 1968 392 215 
3 6 925 1874 1485 1241 35 1846 
3 5 1846 865 685 989 1050 
3 4 1050 229 1805 460 
3 4 460 349 724 1789 
3 5 1789 656 439 249 111 
3 6 111 1144 1027 682 941 1758 
3 7 1758 1757 1754 489 1591 228 1740 
3 11 1740 884 104 896 1380 1726 7 580 1715 1039 1295 
3 5 304 330 6 995 400 
3 4 400 198 889 1354 
3 3 1354 435 1295 
3 13 1295 1039 1715 580 7 1726 1380 896 104 884 1740 228 1591 
3 7 249 487 1160 447 966 1765 1137 
3 7 1137 1759 1097 860 1164 1287 947 
3 8 1214 751 185 1556 292 188 180 1295 
3 4 304 1596 1522 95 
3 6 1666 1665 956 224 290 1540 
3 2 1485 1853 
3 5 1853 871 1835 163 1845 
3 6 1845 1270 221 1385 987 1007 
3 3 1007 38 370 
3 4 370 1374 76 1162 
3 10 1162 1798 1800 1191 1804 569 1807 678 1815 459 
3 8 1826 1825 317 577 1251 1821 296 459 
3 4 1835 789 345 1005 
3 5 1005 551 1806 1801 272 
3 9 1377 1496 963 1304 1121 1786 1013 1566 272 
3 15 215 1042 1981 1989 626 589 360 1977 731 282 1273 955 829 534 1983 
3 12 1983 1510 1118 1443 1434 501 1487 518 220 2007 173 2004 
3 12 2004 1593 1546 1302 110 66 1187 2025 1172 723 2017 2014 
3 6 2014 2020 2027 1208 844 2024 
3 6 823 1106 343 2048 885 994 
3 4 994 745 1145 226 
3 7 226 838 2084 959 2095 61 2098 
3 6 2098 1527 1184 1340 805 275 
3 7 275 1560 1515 672 665 1398 1078 
3 6 1010 1548 793 1554 1068 245 
1 9 982 1106 358 826 348 408 1201 1226 1032 
1 5 1226 1534 442 2085 2083 
1 3 2083 791 52 
1 5 52 167 1346 943 1435 
1 7 1435 655 768 1411 688 586 1481 
1 7 1481 1392 151 1338 288 2116 92 
1 5 982 2028 2029 2037 994 
1 4 885 1044 2033 982 
1 4 1468 1267 714 994 
1 3 1468 863 1415 
1 4 863 1249 520 2081 
1 3 2081 2071 226 
1 4 520 245 1258 1102 
1 2 1258 1554 
1 4 520 535 344 793 
1 3 793 1325 1548 
1 3 959 1163 2095 
1 2 1527 926 
1 3 2028 1044 2048 
1 4 745 2059 149 2048 
1 2 2059 1145 
1 9 838 1221 2075 1001 1410 1536 2078 1297 442 
1 5 2048 1154 2061 902 1001 
1 9 2098 2097 659 980 143 466 75 2090 2085 
1 4 665 1103 1261 1078 
1 7 1078 2115 2122 1140 2126 1157 1512 
1 3 1398 1277 2114 
1 6 805 824 2110 529 14 2114 
1 4 384 1324 2112 1481 
1 4 2114 641 1122 384 
1 5 384 1355 1516 375 14 
